NO ./images/wall_low_poly_64x64_1.png
SO ./images/wall_low_poly_64x64_2.png
WE  ./images/wall_low_poly_64x64_3.png
EA ./images/wall_low_poly_64x64_4.png

F 220,100,0
C 225,32,220

        1111111111111111111111111
        1000000000100000000000001
        1011000001110S00000000001
        1001000000000000000000001
111111111011000001110000000000001
10000000001100000111000111111111111
11110111111111011100000010001
11110111111111011101010010001
11000000110101011100000010001
10000000000000001100100010001
10000000000000001101 10011111
110000011101010111110110111111
11110111 1110101 101111011111
11111111 1111111 111111111111
          









