NO ./images/wall_low_poly_64x64_1.png
SO ./images/wall_low_poly_64x64_2.png
WE ./images/wall_low_poly_64x64_3.png
EA ./images/wall_low_poly_64x64_4.png


F 225,206,154
C 46,0,108



         11111111          11111111
111111111100000011111111111100000011111111111
100000000000000000000000000000000000000000001
100000000000000000000000000000000000000000001
100000000000000000000000000000000000000000001
100000000000000000000000000000000000000000001
100000000000000000000000000000000000000000001
100000000000000000000000000000000000000000001
100000000000000000000000000000000000000000001
100000000000000000000000000000000000000000001
100000000000000000000000000000000000000000001
100000000000000000000000000000000000000000001
100000000000000000000000000000000000000000001
100000000000000000000000000000000000000000001
110011111111111111000000111111111111111111111
10001            11111111
10111111111111111111111111111111111111
10000000001100000000000000000000000001
10111111001111111111111111101111111001
10100001000000000000001110000000001011
10101111011111101111101110111111001001
10100000010000100000100010100001001101
10101111110111101110111010111001001001
10100000010000000010100010100001001011
10111111011111111110111010101111001001
10000001000000000000001010100000001101
10111101111101111111011010111111001001
10000000000001000001000000000000001011
10111111011111011101111111101111111001
10000001000000000000000000100000000001
11111001101111111111111110111111111001
10001000000000000000000010000000001001
10101110101111101111111110111111010001
10100000101000100000000010001000010001
10111111100010101111111110101111110001
11111111111111111111111111111111111011
                               1000011
        111111111111111111111111100111
        1000000000110010000100000011
        10110000011100100001000011
        1001000000010010000000011
11111111101100000111000000010001
10000000001100000111011000011111
11110111111111010000000000001
11110111111111011101010010001
11000000110101011100000010001
10000000000000001100000010001
10000000000000001101010010001
110000011101010111110111100111
11110111 1110101 101100011111
11110001 1111111 111000111111
   1001111111      110111111
   1000100001  11111101
   1010001001  10000001
   1011110001  10111111      11111
  11011110111111011111111111110001
  10000000000000000000000000000001
  11111111011000011111111111110001
        11110000011       111000011
      110000000001111111111111000011111111
        10000000001000000000000011
        1011000001110S00000000001
        1001000000000000000000001
111111111011000001110000000000001
10000000001100000111000111111111111
11110111111111011100000010001
11110111111111011101010010001
11000000110101011100000010001
10000000000000001100100010001
10000000000000001101 10011111
110000011101010111110110111111
11110111 1110101 101111011111
11111111 1111111 111111111111